{
  "mazes": [
    {
      "id": "demo-5x5",
      "name": "Démo 5x5",
      "grid": [
        "#####",
        "#S..#",
        "#.#.#",
        "#..C#",
        "#####"
      ]
    },
    {
      "id": "couloir-7x5",
      "name": "Couloir 7x5",
      "grid": [
        "#######",
        "#S....#",
        "###.#C#",
        "#.....#",
        "#######"
      ]
    },
    {
      "id": "rafales-9x7",
      "name": "Rafales 9x7",
      "grid": [
        "#########",
        "#S......#",
        "#.###.#.#",
        "#...#...#",
        "#.#.#C#.#",
        "#....C..#",
        "#########"
      ]
    }
  ]
}