{
  "mazes": [
    {
      "id": "facile",
      "name": "Facile",
      "grid": [
        "#######",
        "#.....#",
        "#.#.#.#",
        "#..C..#",
        "#.#.#.#",
        "#.C..C#",
        "#######"
      ]
    },
    {
      "id": "moyen",
      "name": "Moyen",
      "grid": [
        "##########",
        "#........#",
        "#.#.###..#",
        "#.#...#..#",
        "#...#..C.#",
        "#.###.##.#",
        "#...#....#",
        "#..#...#C#",
        "#C....C..#",
        "##########"
      ]
    },
    {
      "id": "difficile",
      "name": "Difficile",
      "grid": [
        "############",
        "#.......C..#",
        "#.###.#.##.#",
        "#...#.#....#",
        "#.#.#.#.##.#",
        "#...#....C.#",
        "#.###.#.##.#",
        "#..C#.#.##.#",
        "#.##.......#",
        "#.##.#####.#",
        "#C....#...C#",
        "############"
      ]
    }
  ]
}